- come :: komen
- get :: krijgen
- give :: geven
- go :: gaan
- keep :: houden
- let :: laten
- make :: maken
- put :: zetten
- seem :: lijken (like)
- take :: nemen
- be :: zijn
- passive of to be :: worden
- do :: doen
- have :: hebben
- say :: zeggen
- see :: zien, schouwen
- look :: kijken
- send :: zenden / sturen
- may :: mogen
- will :: zullen
- about :: over
- across :: over
- after :: na
- against :: tegen
- among :: onder (e.g. onder vrienden)
- at  :: in/op/bij/ten
- before :: voor
- between :: tussen
- by :: bij
- down :: beneden (beneath) / naar beneden (e.g. down to the river)
- from :: van
- in :: in
- off :: af
- on :: op
- over :: over
- through :: door
- to :: naar (direction), aan (w/ person as i.o.)
- under :: onder
- up :: omhoog
- with :: met
- as/if :: als
- already :: al,alvast
- for :: voor
- of :: van
- till :: tot
- than :: dan
- a :: een
- the :: de/het
- all :: alles (n) / alle (adj)
- any :: elke
- every :: alle
- no :: nee / geen (adj) 
- other :: ander
- some :: sommige / enkele
- such :: zulk (e.g. zulk meisje --Lies).
- that :: dat (n. s.) / die (everything else)
- this :: dit (n. s.) / deze (everything else)
- I :: ik
- he :: hij
- you :: jij/u
- who :: wie
- and :: en
- because :: omdat
- but :: naar
- or :: of
- if :: als
- though :: toch
- while :: terwijl
- how :: hoe
- when :: wanneer
- where :: waar
- why :: waarom (wherefore)
- waarme :: with which (e.g. 17 dingen waar vegetariers mee moeten leven
- again :: opnieuw
- ever :: ooit
- far :: ver
- forward :: vooruit
- here :: hier
- near :: dichtbij
- now :: nu
- out :: uit
- still :: nog steeds
- then :: dan (about the present/future) / toen (about the past)
- there :: daar / er (there is)
- together :: samen
- well :: wel / goed (alles gaat goed)
- almost :: bijna
- enough :: genoeg
- even :: zelfs (e.g. ik heb zelfs een auto)
- little :: klein (adj) weinig (adv)
- very :: heel
- much :: veel
- not :: niet
- only :: alleen
- quite :: heel
- so :: zo
- tomorrow :: morgen
- yesterday :: gisteren
- north :: noord(en)
- south :: zuid(en)
- east :: oost(en)
- west :: west(en)
- please :: alsjeblieft/alsublieft
- yes :: ja
- inside :: binnen
- head :: hoofd
- therefore :: daarom (lit. there-for)
- often :: vaak
- clear :: helder
- simple :: gewoon
- to merge :: samensmelten
- today :: vandaag
- to pay :: betalen (mnemonic: Romans paid Judas thirty TALENts of silver)
- to start/initiate :: invoeren (Het parlement...voert een boete in).  
- voice :: de stem (f) 
- law :: de wet (f) (lady law wearing a blindfold)
- design/proposal :: het ontwerp
- to stop (idiom) :: komaf maken met (to make history with)
- total :: volledig
- according to :: volgens (following)
- to follow :: volgen
- extra :: bijkomende (by-coming, on-top-of-coming)
- course :: de cursus (m, as in latin) 
- circumstances :: omstadigheden (om-standig-heden: around-standing-states)
- wherein :: waarin
- to happen :: gebeuren
- to provide :: voorzien
- in spite of :: ondanks (not thanks-to!)
- to call/shout :: roepen
- herroepen :: to revoke (back-call)
- to supervise :: begeleiden [leden = lead]
- to hurt :: kwetsen
- vulnerable :: kwetsbaar (hurtable)
- next to :: naast
- additionally :: daarnaast (there-next-to)
- case :: het geval
- pregnant :: zwanger
- violence :: het geweld
- act :: de daad
- acts of violence :: gewelddaden
- to hear :: horen.
- lucky :: gelukkig
- to put with (to take) :: te maken krijgen met (Hier zijn alvast de 17 meest vervelen
- for example :: bijvoorbeeld
- to give :: geven
- indeed :: inderdaad
- to understand :: begrijpen
- understanding :: begripvol
- result :: gevolg
- during :: tijdens
- to finish :: aflopen [when a process ends naturally], be\"eindigen [when you finish a process actively
- finished :: afgelopen
- sometimes :: soms
- to get (become) :: geraken
- developmental disorder :: ontwikkelingstoornis 
- to suffer :: lijden
- to talk :: praten
- heavy :: zwaar
- forget :: vergeten
- until :: tot, totdat
- return :: terugkomen (back-come) [to the place where you are now], terugkeren [to a place where you are not]; Loop niet weg, kom terug! vs. It is now safe to return to your desks -- Jullie kunnen terugkeren naar jullie bureau's.
- to read :: lezen
- mostly :: meestal [I mostly eat out -- Meestal ga ik uit eten]; voornamelijk [There are mostly girls in the bio department -- Er zijn voornamelijk meisjes in het departement biologie]
- to annoy :: ambeteren [ <3 Flemish ]
